/////////////////////////////////////
/......./.../.../........./........./
/././//././////.///././././//./////./
/./.../...../....././././.../....././
/////./////////.///./////./////.///./
/........./......././.../....././.../
/./////////////./////.///////.///.///
/...../...../......./.../.../././.../
/././//.///./././////./////././././//
/././.../....././.../....././.../.../
///././//////././././//.///././//.///
/..........././.../.../......./..././
/////.///////////.///////////.///././
/......./...../....././...../.../.../
/////./////.///////././././////./././
/.............../......./........./*/
/////////////////////////////////////